.............
.............
.............
.............
...c..c..c...
...y..b..c...
...b..y..c...
...y..b..c...
...b..y..c...
.............
.............
.............
.............