................
................
................
................
...cc..cc..cc...
...yy..bb..cc...
...bb..yy..cc...
...yy..bb..cc...
...bb..yy..cc...
................
................
................
................