................
..cc.cc.cc.cc...
..gg.oo.oo.pp...
..pp.oo.gg.yy...
..gg.oo.yy.pp...
..bb.yy.pp.gg...
................
...cc..cc..cc...
...yy..cc..cc...
...bb..cc..cc...
...bb..cc..cc...
...bb..cc..cc...
................