...........
..c.c.c.c..
..g.o.o.p..
..p.o.g.y..
..g.o.y.p..
..b.y.p.g..
...........
...........
..c..c..c..
..y..c..c..
..b..c..c..
..b..c..c..
..b..c..c..